                                                                                                                                                                                                                                                                                                                                                                                                                
                                                                                                                                                                                                                                                                                                                                                                                                                
                                                                                                                                                                                                                                                                                                                                                                                                                
                                                                                                                                                                                                                                                                                                                                                                                                          
                                                                                                                                                                                                                                                                                                             ▓                                                                                                  
                                                                                                                                                                                                                                                                    ▓▓▓▓▓▓▓▓▓▓                                                                                               
                                                                                                                                                                                                                                                                                                     ▓▓███████▓▓▓                                                                                               
                                                                                                                                                                                                                                                                                                   ▓▓▓ █████████▓▓▓█                                                                                            
                                                                                                                                                                                                                                                                                               ▓▓▓██████████████▓▓▓▓▓                                                                                         
                                                                                                                                                                                                                                                                                                ▓▓▓███████████████████▓▓▓                                                                                       
                                                                                                                                                                                                                                                                                              ▓▓█████████████████████▓▓▓▓                                                                                      
                                                                                                                                                                                                                                                                                                ▓████████████████████████▓▓▓▓▓▓                                                                                 
                                                                                                                                                                                                                                                                                              ▓▓▓▓███████████████████████████▓▓▓                                                                                
                                                                                                                                                                                                                                                                                             ▓█████████████████████████████████▓▓▓▓▓   █                                                                        
                                                                                                                                                                 ▓▓ ▓▓▓▓▓▓▓▓▓▓▓▓▓▓▓                                                                                                       ▓▓▓    ██████████████████████████████▓▓█▓▓▓▓▓▓                                                                       
                                                                                                                                                              ▓▓▓▓█▓▓▓▓█▓▓▓▓▓▓██▓▓▓▓▓▓                                                                                                     ▓██  ████████████████████████████████████████▓▓                                                                      
                                                                                                       ▓▓                                              ▓    ▓▓▓█████████████████████▓██▓▓▓                                                                                                 ▓█████████████████████████████████████████████▓▓                                                                     
                                                                                                    ▓▓▓█▓▓▓                                   ▓▓ ▓▓▓▓▓▓▓▓▓▓▓██████████████████████████████▓▓▓▓▓▓▓  ▓                                                                                       ▓ ██ ███████████████████████████████████████████▓▓▓                                                                  
                                                                                                 ▓ ▓███▓███▓                                ▓ ▓▓▓████████████████████████████████████████████████▓▓▓▓                                                                                       ▓██ █████████████████████████████████████████████▓▓                                                                 
                               ▓▓▓▓▓▓▓▓▓▓▓▓▓▓▓▓▓▓                                        ▓▓▓▓▓▓▓▓▓▓██████▓█▓▓                  ▓▓▓▓▓▓▓▓▓▓▓▓▓▓▓▓▓██████████████████████████████████████████████████▓█▓▓▓▓▓▓▓▓                                                                              ▓▓██████████████████████████████████████████████████▓▓▓ █    ▓▓▓                       ▓▓ ▓▓▓▓  ▓                     
                               ▓█████████████▓█▓▓▓                                       ▓▓█████████████████▓▓▓▓           ▓  ▓▓████████████████████████████████████████████████████████████████████▓▓▓▓▓▓▓▓▓▓▓▓▓▓▓▓ ▓  ▓▓▓▓                                                              ▓▓██████████████████████████████████████████████████ █▓▓▓▓▓█▓▓▓▓▓▓▓▓▓▓▓▓▓▓▓▓▓▓▓▓▓▓▓▓▓▓▓▓▓▓▓▓▓▓▓▓▓▓▓▓▓▓▓▓▓▓            
                             ▓▓▓█████████████████▓▓                                   ▓▓▓▓████████████████████▓▓▓        ▓▓▓▓▓██████████████████████████████████████████████████████████████████████████████████▓▓▓▓▓▓▓▓▓▓▓▓▓▓▓▓▓▓▓▓▓▓▓▓                                                  ▓▓███████████████████████████████████████████████████████████████████████████████████████████████████████▓▓▓ ▓        
                             ▓▓███████████████████▓▓▓▓▓▓▓▓▓▓▓▓▓   ▓                  ▓▓█████████████████████████▓▓▓▓    ▓▓████████████████████████████████████████████████████████████████████████████████████████████████████████████▓▓▓▓▓▓▓▓                                          ▓▓▓██████████████████████████████████████████████████████████████████████████████████████████████████████████▓▓▓▓▓▓     
               ▓▓▓▓▓▓▓▓▓▓▓▓▓▓▓██████████████████████████████████▓▓▓              ▓▓▓▓█████████████████████████████▓▓▓▓▓▓███████████████████████████████████████████████████████████████████████████████████████████████████████████████████████▓▓▓▓▓▓▓  ▓▓  ▓                          ▓▓█████████████████████████████████████████████████████████████████████████████████████████████████████████████████▓▓▓▓▓▓
             ▓▓▓▓▓█▓███████████████████████████████████████████████▓▓ ▓▓▓      ▓▓████████████████████████████████████████████████████████████████████████████████████████████████████████████████████████████████████████████████████████████████████▓▓▓▓▓▓▓▓▓  ▓ ▓ ▓                ▓▓▓███████████████████████████████████████████████████████████████████████████████████████████████████████████████████████▓
         ▓▓▓▓▓██████████████████████████████████████████████████████████ ▓▓▓▓▓▓▓█████████████████████████████████████████████████████████████████████████████████████████████████████████████████████████████████████████████████████████████████████████████▓▓▓▓▓▓▓▓▓▓▓▓▓▓▓▓▓▓▓▓▓▓▓▓▓▓█████████████████████████████████████████████████████████████████████████████████████████████████████████████████████████
     ▓▓▓▓█████████████████████████████████████████████████████████████████████████████████████████████████████████████████████████████████████████████████████████████████████████████████████████████████████████████████████████████████████████████████████████████████▓██▓▓█████████████████████████████████████████████████████████████████████████████████████████████████████████████████████████████████
▓▓▓▓▓▓██████████████████████████████████████████████████████████████████████████████████████████████████████████████████████████████████████████████████████████████████████████████████████████████████████████████████████████████████████████████████████████████████████████████████████████████████████████████████████████████████████████████████████████████████████████████████████████████████████████
████████████████████████████████████████████████████████████████████████████████████████████████████████████████████████████████████████████████████████████████████████████████████████████████████████████████████████████████████████████████████████████████████████████████████████████████████████████████████████████████████████████████████████████████████████████████████████████████████████████████
████████████████████████████████████████████████████████████████████████████████████████████████████████████████████████████████████████████████████████████████████████████████████████████████████████████████████████████████████████████████████████████████████████████████████████████████████████████████████████████████████████████████████████████████████████████████████████████████████████████████